11111111111111111111111111111111111111111111111111111111
11111111111111111111111111111111111111111111111111111111
11111111111111111111111111111111111111100011111111111111
11111111111111111111111111111111111111100011111111111111
11111111111111111111333333333333333100000011111111111111
11111111111111111111333333333333333100000011111111111111
11111111111111111111311111111111111100000011111111111111
11111111111111111111311111111111111100010011111111111111
11111111111111111111300000000000000100000010111111111111
11111111111111111111310000000000000100000010111111111111
11111111111111111111310000000000000000000000000011111111
11111111111111111111310000000000000000000000000011111111
11111111111111111133310000000000000100000000000000111111
11111111111111111133310000000000000100000000000000111111
11111111111111133333311111111111111100000011111110111111
11111111111111133333311111111111111100000011111110111111
11111111111113333333310000000000000000000011111110001111
11111111111113333333310000000000000000000111111110001111
11111111111113333333310000001111111111000000000010001111
11111111111111111111110111111111111111000000000010001111
10222222010000000000000000000000001111001111111100001111
10222222010011111111110000000000001111111111111100001111
10222222010111111111100000000000000000001111111100001111
10222222010111111111100000000000000000011111111111111111
10222222000111111111100000000000000000000000000001111111
10222222000111111111100000000000000000000001000001111111
11111111111111111111100000001111000000001111000001111111
11111111111111111111100000001111000000001111000001111111
11111111111111111111100000001111001111111111111101111111
11111111111111111111100000111111001111111111111101111111
11111111111111111111100000000000000000000000000001111111
11111111111111111111111111111111111111111111111111111111
11111111111111111111111111111111111111111111111111111111
11111111111111111111111111111111111111111111111111111111
11111111111111111111111111111111111111111111111111111111
11111111111111111111111111111111111111111111111111111111