111111111111
100000000001
103333333301
103330033301
103000000301
103333330301
103333330301
103000000301
103033033301
103033033301
103000000301
103033033301
103033033301
103000033301
103330033301
103100010301
103100010301
100000000001
100000000001
111114411111
